16 64
s00 s00 s00 s00 s00 s00 s00 s00 s00 s00 s00 s00 s00 s00 s00 s00 s00 s00 s00 s00 s00 s00 s00 s00 s00 s00 s00 s00 s00 s00 s00 s00 s00 s00 s00 s00 s00 s00 s00 s00 s00 s00 s00 s00 s00 s00 s00 s00 s00 s00 s00 s00 s00 s00 s00 s00 s00 s00 s00 s00 s00 s00 s00 s00
s00 h20 s00 h30 s00 s00 s00 s00 s00 s00 s00 s00 s00 s00 s00 s00 s00 s00 s00 s00 s00 s00 s00 s00 s00 s00 s00 s00 s00 s00 s00 s00 s00 s00 s00 s00 s00 s00 s00 s00 s00 s00 s00 s00 s00 s00 s00 s00 s00 s00 s00 s00 s00 s00 s00 s00 s00 s00 s00 s00 s00 s00 s00 s00
s00 s00 s00 s00 s00 s00 s00 s00 s00 s00 s00 s00 s00 s00 s00 s00 s00 s00 s00 s00 s00 s00 s00 s00 s00 s00 s00 s00 s00 s00 s00 s00 s00 s00 s00 s00 s00 s00 s00 s00 s00 s00 s00 s00 s00 s00 s00 s00 s00 s00 s00 s00 s00 s00 s00 s00 s00 s00 s00 s00 s00 s00 s00 s00
s00 s01 s00 s00 s00 s00 s00 s00 s00 s00 s00 s00 s00 s00 s00 s00 s00 s00 s00 s00 s00 s00 s00 s00 s00 s00 s00 s00 s00 s00 s00 s00 s00 s00 s00 s00 s00 s00 s00 s00 s00 s00 s00 s00 s00 s00 s00 s00 s00 s00 s00 s00 s00 s00 s00 s00 s00 s00 s00 s00 s00 s00 s00 s00
s00 s00 s00 s00 s00 s00 s00 s00 s00 s00 s00 s00 s00 s00 s00 s00 s00 s00 s00 s00 s00 s00 s00 s00 s00 s00 s00 s00 s00 s00 s00 s00 s00 s00 s00 s00 s00 s00 s00 s00 s00 s00 s00 s00 s00 s00 s00 s00 s00 s00 s00 s00 s00 s00 s00 s00 s00 s00 s00 s00 s00 s00 s00 s00
s00 s00 s00 s01 s00 s00 s00 s00 s00 s00 s00 s00 s00 s00 s00 s00 s00 s00 s00 s00 s00 s00 s00 s00 s00 s00 s00 s00 s00 s00 s00 s00 s00 s00 s00 s00 s00 s00 s00 s00 s00 s00 s00 s00 s00 s00 s00 s00 s00 s00 s00 s00 s00 s00 s00 s00 s00 s00 s00 s00 s00 s00 s00 s00
s00 s00 s00 s00 s00 s00 s00 s00 s00 s00 s00 s00 s00 s00 s00 s00 s00 s00 s00 s00 s00 s00 s00 s00 s00 s00 s00 s00 s00 s00 s00 s00 s00 s00 s00 s00 s00 s00 s00 s00 s00 s00 s00 s00 s00 s00 s00 s00 s00 s00 s00 s00 s00 s00 s00 s00 s00 s00 s00 s00 s00 s00 s00 s00
s00 s00 s00 s00 s00 s01 s00 s00 s00 s00 s00 s00 s00 s00 s00 s00 s00 s00 s00 s00 s00 s00 s00 s00 s00 s00 s00 s00 s00 s00 s00 s00 s00 s00 s00 s00 s00 s00 s00 s00 s00 s00 s00 s00 s00 s00 s00 s00 s00 s00 s00 s00 s00 s00 s00 s00 s00 s00 s00 s00 s00 s00 s00 s00
s00 s00 s00 s00 s00 s00 s00 s00 s00 s00 s00 s00 s00 s00 s00 s00 s00 s00 s00 s00 s00 s00 s00 s00 s00 s00 s00 s00 s00 s00 s00 s00 s00 s00 s00 s00 s00 s00 s00 s00 s00 s00 s00 s00 s00 s00 s00 s00 s00 s00 s00 s00 s00 s00 s00 s00 s00 s00 s00 s00 s00 s00 s00 s00
s00 s00 s00 s00 s00 s00 s00 s01 s01 s00 s00 s00 s00 s00 s00 s00 s00 s00 s00 s00 s00 s00 s00 s00 s00 s00 s00 s00 s00 s00 s00 s00 s00 s00 s00 s00 s00 s00 s00 s00 s00 s00 s00 s00 s00 s00 s00 s00 s00 s00 s00 s00 s00 s00 s00 s00 s00 s00 s00 s00 s00 s00 s00 s00
s00 s00 s00 s00 s00 s00 s00 s00 s00 s00 s00 s00 s00 s00 s00 s00 s00 s00 s00 s00 s00 s00 s00 s00 s00 s00 s00 s00 s00 s00 s00 s00 s00 s00 s00 s00 s00 s00 s00 s00 s00 s00 s00 s00 s00 s00 s00 s00 s00 s00 s00 s00 s00 s00 s00 s00 s00 s00 s00 s00 s00 s00 s00 s00
s00 s00 s00 s00 s00 s00 s00 s00 s00 s00 s00 s00 s00 s00 s00 s00 s00 s02 s00 s00 s01 s00 s00 s00 s01 s01 s00 s00 s00 s00 s00 s00 s00 s00 s00 s00 s00 s00 s00 s00 s00 s00 s00 s00 s00 s00 s00 s00 s00 s00 s00 s00 s00 s00 s00 s00 s00 s00 s00 s00 s00 s00 s00 s00
s00 s00 s00 s00 s00 s00 s01 s01 s01 s01 s00 s00 s00 s00 s00 s00 s00 s01 s00 s00 s01 s00 s00 s00 s01 s01 s00 s00 s00 s00 s00 s00 s00 s00 s00 s00 s00 s00 s00 s00 s00 s00 s00 s01 s00 s00 s01 s00 s00 s00 s00 s00 s00 s00 s00 s00 s00 s00 s00 s00 s00 s00 s00 s00
s00 s00 s00 s00 s00 s00 s00 s00 s00 s00 s00 s01 s00 s00 s00 s00 s00 s01 s00 s00 s01 s00 s00 s00 s01 s01 s00 s00 s00 s00 s00 s00 s00 s00 s00 s00 s00 s00 s00 s00 s00 s00 s01 s01 s00 s00 s01 s01 s00 s00 s00 s00 s00 s00 s00 s00 s00 s00 s00 s00 s00 s00 s00 s00
s00 s00 s00 s00 s00 s00 s00 s00 s00 s00 s00 s00 s00 s00 s00 s00 s00 s01 s00 s00 s01 s00 s00 s00 s01 s01 s00 s00 s00 s00 s00 s00 s00 s00 s00 s00 s00 s00 s00 s00 s00 s01 s01 s01 s00 s00 s01 s01 s01 s00 s00 s00 s00 s00 s00 s00 s00 s00 s00 s00 s00 s00 s00 s00
s01 s01 s01 s01 s01 s01 t029 s01 s01 s01 s01 s01 s01 s01 s01 s01 s01 s01 s01 s01 s01 s01 s01 s01 s01 s01 s01 s01 s01 s01 s01 s01 s01 s01 s01 s01 s01 s01 s01 s01 s01 s01 s01 s01 s00 s00 s01 s01 s01 s01 s01 s01 s01 s01 s01 s01 s01 s01 s01 s01 s01 s01 s01 s01